[___________________________________________________________]
|                                                           |
|                                                           |
|                                                           |
|                                                           |
|                     > < + - [ ] ,      del                |
|                                                           |
|                                        ENTER              |
|                                                           |
|                                                           |
|                                                           |
|                                                           |
|                                                           |
|                                                           |
|                                                           |
|                                                           |
|                                                           |
|                                                           |
[___________________________________________________________]
